1 1 1 1 1 1 1 1 1 1 1 1 1 1 1 1 
1 0 0 0 0 0 0 0 0 0 0 0 0 0 0 1
1 0 1 1 1 1 1 1 0 0 0 0 0 0 0 1
1 0 1 4 4 4 4 1 0 5 6 6 6 7 0 1
1 0 1 4 4 4 4 1 0 8 2 2 2 9 0 1
1 0 1 4 4 4 4 4 0 8 2 2 2 9 0 1
1 0 1 4 4 4 4 4 0 8 2 2 2 9 0 1
1 0 1 4 4 4 4 1 0 8 2 2 2 9 0 1
1 0 1 4 4 4 4 1 0 10 11 11 11 12 0 1
1 0 1 1 1 1 1 1 0 0 0 0 0 0 0 1
1 0 0 0 0 0 0 0 0 0 0 0 0 0 0 1
1 1 1 1 1 1 1 1 1 1 1 1 1 1 1 1 